########################################
#       #               *              #
# ^***      #*#  # #    *              #
#**+  *   *   * *   ## ^*  * **        #
#   #  *  # #     *   ##*        * *   #
# *    #    *@ *  #*         *  *      #
#  *    *   ***     # #+#              #
#  *  *  **    ** *  *#          *   * #
#   ***    **  *  #    #*  *   *       #
#  #* #* #   *     *#*  #              #
# #    ##  #   *  * *  #*    *     *   #
#    # *# #  #  *   * #+               #
#   *#*  #  *  *  #*  * *       *      #
#  # # * * *#^#  #  #*      *          #
##  #  ** *  # ## *  # **       !  *   #
###                                    #
########################################