###################################
#     #       #       #           #
# ### ##### ### ### ### ##### ### #
# #       #       #       #     # #
# # ##### ##### ##### ##### ##### #
# #     #   #       #     #       #
# ### # ### ##### ### ### ##### ###
#     #     #       #     #       #
##### ##### ### ##### ### ##### ###
#       #       #       #         #
# ### ##### ### ##### ##### ##### #
# #       #   #     #       #     #
# ### ##### ### ### ##### ##### ###
# #       #       #     #         #
# ##### ##### ##### ### ### ##### #
#     #       #     #       #     #
###################################