###################################
#                                 #
#                                 #
#                                 #
#                                 #
#             @                   #
#                                 #
#                                 #
#                                 #
#                                 #
#                                 #
#                                 #
#                                 #
#                                 #
#                                 #
#                                 #
###################################