#####################
#                   #
#             #     #
#    #              #
#                   #
#   #          #    #
#                   #
#     #      #      #
#                   #
#  #       #        #
#                   #
#####################