########################################
#       #       @       #              #
#  ##       ##  **#     #     ###      #
###    ###      *   ##  #      #       #
#      ##   #      #    ###         #  #
#   #   #   *  #  ##    #  ####   #    #
# #^   ##       ###     # # ###        #
#  ###      ##   +#  ## *      #       #
#     ##    ###   #  #+   ##  #        #
#  ## ## #   #* # #  ### #      ##     #
# #    +#  #   #  #   ^###    #     #  #
#    * ###   #      # #                #
#   ###   #     ##  # #    ####        #
#   #  ## #^##  #   ##       ##        #
##  #    # #  #*# ##  # ##             # 
###                                    #
########################################