########################################
#       #               #              #
#@ #*       **  **#     #     ***      #
#**    #**      *   *#  #      *       #
# *   **   *      *    ***         #   #
#   *   *   *  *  **    *  ****   #    #
# #^   **       ***     # * ***        #
#  ***      **   +#  ** *      *       #
#     *#    ***   #  #+   **  *        #
#  ## ** #   #* * *  *** *      **     #
# *    +*  #   #  *   ^***    *     *  #
#    * ***   #      * *                #
#   ***   *     ##  *  *   ****        #
#   *  ** #^**  #   #*       **  ***   #
#*  #    # #  *** **  * **             #
##*                              **    #
########################################