########################################
#       #               *              #
# ^***      #*#  # #    *              #
#**+  *   *   * *   ## ^*  * **        #
#   #  *  # #     *   ##*        * *   #
# *    #    *@ *  #*    #    *  *      #
#  *    *   ***     # #+#              #
#  *  *  **    ** *  *#          *   * #
#   ***    **  *  #    #*  *   *       #
#  #* #* #   *     *#*  #              #
# #    ##  #   *  * *  #*    *     *   #
#    # *# #  #  *   * #+               #
#   *#*  #  *  *  #*  * *       *      #
#  # # * * *#^#  #  #*      *          #
##  #  ** *  # ## *  # **          *   #
###                                    #
########################################