########################################
#       #       @       #              #
# ^###      ###  # #    #              #
###   #   #   # #   ## ^#   #          #
#   #  #  # #     #   ###         #    #
# #    #    #  #  ##    #     #        #
#  #    #   ###     # # #              #
#  #  #  ##    # #  #  ##          #   #
#   ###    ##  #  #    ##  #   #       #
#  ## ## #   # #   ###  #              #
# #    ##  #   #  # #  ##    #     #   #
#    # ## #  #  #   # #                #
#   ###  #  #  #  ##  # #       #      #
#  # # # # ##^#  #  ##      #          #
##  #  ## #  # ## #  # ##          #   # 
###                                    #
########################################