########################################
#       #       @       #              #
#   ###   ##        ##   #     ###      #
###   #      ###        ##  #           #
#  #  ##    #   #  #  ###         #     #
# #     #   #  #    ##    #  ####   #   #
#   ##   ##     ###       # # ###       #
#   #     #  ##   ##  # ##      #       #
#   ###       ##  #^  #     ###         #
#  ##^##   ##  #   ##    #      ##      #
# #    ##  #   #     #  ###    #    #   #
#    # ## #  #    #  #                 ##
#   ###  #   # ##  # ##    ####         #
#  #  ##  ##  ^#   ##       ##   ##     #
##  #     #  ### ##   # ##              # 
###                                    #
########################################
