########################################
#        *^ *    *     *      *        #
#   *     *     *     *   *       *    #
#  +*     ** * * * * * * * **  **+  *  #
#   *  *   *   *     *   *   *   * *   #
#         *        *    *      **  *   #
#  *    *    ******   ******    *   *  #
#     *   !       *   *           *    #
#    *  *******   * @ *   *******   *  #
#   *   *                      *  *    #
#     *    ********   ********  *    * #
#  *   * *     *   *      *        *   #
#     * + *   *     *    *     *       #
#  *   *  **     *   *     *    *  *   #
# ^      *    *     *  *  *    *    *  #
#**                   *        * ^     #
########################################